00000000000000000000000000000000000000000000000000000000000000000000000000000000
00000000000000001000000100000000000000000000000000000000000000000000000000000000
00000000000000011100001110000000000000000000000000000000000000000100000000000000
000000000000001001000010010000000000000000000000000000000000000001100000000000000
00000000000001110000000011100000000000000000000000000000000000000101000000000000
00000000000000101000000101000000000000000000000000000000000000000010000000000000
00000000000000001100001100000000000000000000000000000000000000000000000000000000
00000000000010000100001000000000000000000000000000000000000000000000000000000000
00000000000000000100001000000000000000000000000000000000000000000000000000000000
00000000000011000100001000110000000000000000000000000000000000000000000000000000
00000000000000100100001001000000000000000000000000000000000000000000000000000000
00000000000000001000000100000000000000000000000000000000000000000000000000000000
00000000000000000000000000000000000000000000000000000000000000000000000000000000
00000000000000000000000000000000000000000000000001100000000000000000000000000000
00000000000000000000000000000000000000000000000010010000000000000000000000000000
00000000000111110000000000000000000000000000000010100000000000000000000000000000
00000010000100000000000000000000000000000000001101000100000000000000000000000000
00000010000100000000000000000000000000000000010010001010000000000000000000000000
00000010000001110000000000000000000000000000010100010010000000000000000000000000
00000011110000000100000000000000000000000000001000101100000000000000000000000000
00000000000100000100000000000000000000000000000001010000000000000000000000000000
00000000000100000100000000000000000000000000000010010000000000000000000000000000
00000000111100000000000000000000000000000000000001100000000000000000000000000000
00000000000000000000000000000000000000000000000000000000000000000000000000000000
00000000000000000000000000000000000000000000000000000000000000000000000000000000