00000000000000000000000000000000000000000000000000000000000000000000000000000000
00000000000000000000000000000000000000000000000000000000000000000000000000000000
00000000000000000000000000000000000000000000000000000000000000000000000000000000
00000000000000000000000000000000000000000000000000000000000000000000000000000000
00000000000000000000000000000000000000000000000000000000000000000000000000000000
00000000000000000000000000000000000000000000000000000000000000000000000000000000
00000000000000000000000000000000000000000000000000000000000000000000000000000000
00000000000000000000000000000000000000000000000000000000000000000000000000000000
00000000000000000000000000000000000000000000000000000000000000000000000000000000
00000101010111110100000100000111110000000000000000000000000000000000000000000000
00000101010100000100000100000100010000000000000000000000000000000000000000000000
00000111110111110100000100000100010000000000000000000000000000000000000000000000
00000101010100000100000100000100010000000000000000000000000000000000000000000000
00000101010111110111110111110111110000000000000000000000000000000000000000000000
00000000000000000000000000000000000000000000000000000000000000000000000000000000
00000000000000000000000000000000000000000000000000000000000000000000000000000000
00000000000000000000000000000000000000000000000000000000000000000000000000000000
00000000000000000000000000000000000000000000000000000000000000000000000000000000
00000000000000000000000000000000000000000000000000000000000000000000000000000000
00000101010111110100000100000111110000000000000000000000000000000000000000000000
00000101010100000100000100000100010000000000000000000000000000000000000000000000
00000111110111110100000100000100010000000000000000000000000000000000000000000000
00000101010100000100000100000100010000000000000000000000000000000000000000000000
00000101010111110111110111110111110000000000000000000000000000000000000000000000
00000000000000000000000000000000000000000000000000000000000000000000000000000000